8 8
...#....
...#....
...#....
####....
...#....
...####.
......#.
........
